total:
W: 3, P: 3, S: 3, C: 3
r1:
W: 1, P: 0, S: 0, C: 0
r2:
W: 0, P: 1, S: 0, C: 0
r3:
W: 0, P: 0, S: 1, C: 0
r4:
W: 0, P: 0, S: 0, C: 1
r5:
W: 2, P: 0, S: 0, C: 0
r6:
W: 0, P: 2, S: 0, C: 0
r7:
W: 0, P: 0, S: 2, C: 0
r8:
W: 0, P: 0, S: 0, C: 2
