+------+------+------+------+
|      |      |      |      |
| (r1) | (r2) | (r3) | (r4) |
|  W   |  P   |  S   |  C   |
|      |      |      |      |
+------+------+------+------+
|      |      |      |      |
| (r5) | (r6) | (r7) | (r8) |
|  W W |  P P |  S S |  C C |
|      |      |      |      |
+------+------+------+------+
