+------------------+
|                  |
|  (studio)        |
|                  |
|    W   W   W     |
|                  |
|    P   P         |
|                  |
|        S         |
|                  |
+------------------+
